
  #######
  #.  #.#
  #@  $.#
  #   # #
  #   $.#
 ## $ # #
#  $$. $#
#  .#   #
 ########
 